%%%%%%%%%%%%%%%%%%%%%%%%%
%         %     %       %
%   %%%  %%             %
%%%%%           %%%     %
%                 %     %
%      %%         % %%%%%
%            %          %
%%%%%%%%              %%%
%      %               %%
%             %%        %
%      %                %
%%%%%%%%%%%%%%%%%%%%%%%%%