%%%%%%%%%%
%   %    %
% % % %  %
%     % %%
%%%     %%
%%   %   %
%      %%%
%%% %   %%
%   %    %
%%%%%%%%%%