%%%%%%%
% %   %
%   %%%
%%%   %
% %   %
%   %%%
%%%%%%%