%%%%%%%%%%%%%%%%%%%%%%%%%%%%%%
%         %         %        %
%   %%%  %%                  %
%   %               %        %
%%%%%               %%%      %
%                     %      %
%           %%        %  %%%%%
%                            %
%                 %         %%
%%%%%%%%%%                 %%%
%        %                  %%
%                %%          %
%        %        %          %
%        %                   %
%%%%%%%%%%%%%%%%%%%%%%%%%%%%%%