%%%%%%%%%%%%%%%%%%%%
%......%%%...%GGG%.%
%..%...............%
%...%%%oo....%%%%..%
%....%%%%oo........%
%.%..%%%%%%o.%.%%%.%
%.%....%%%%%.%.....%
%.%%%%...%%....%%%.%
%P.....%....%.o....%
%%%%%%%%%%%%%%%%%%%%