%%%%%%%%%%%%%%%%%%%%%%%%%%%%%%
%         %         %    GGG %
%   %%%  %%                  %
%   %    ..         %        %
%%%%%               %%%      %
%                     %      %
%P          %%        %  %%%%%
%           .                %
%                 %         %%
%%%%%%%%%%  .      .       %%%
% .     .%         .    .   %%
%                %%         .%
%        %        %          %
%        %                   %
%%%%%%%%%%%%%%%%%%%%%%%%%%%%%%